AFAIK - As far as I know
AIDA - Attention  Interest  Desire  Action
AMA - Ask Me Anything
API - Application Programming Interface
ASMR -  Autonomous Sensory Meridian Response
ASL - Age Sex Location
BSAAW - Big smile and a wink
b/c - Because
bc - Because
B2B - Business to business
B2C - Business to consumer
B4 - Before
BAE - Before Anyone Else
BFF - Best Friends Forever
BRB - Be right back
BTAIM - Be that as it may
BTS - Behind the scenes
BWL - Bursting with laughter
BTW - By the way
CC - Carbon copy
CMGR - Community manager
CMS - Content Management System
CMV - Change my view
CPC - Cost per click
CPM - Cost per thousand
CR - Conversion rate
CRM - Customer Relationship Management
CRO - Conversion Rate Optimization
CSL - Cannot stop laughing
CSS - Cascading stylesheet
CTA - Call to action
CTR - Clickthrough rate
CX - Customer experience
DAE - Does anyone else     
DFTBA - Do not forget to be awesome
DM - Direct Message
DYK - Did you know      
ELI5 - Explain like I am 5 years old 
ESP - Email service provider
F2F - Face to face
FaTH - First and Truest Husband
FB - Facebook
FBF - Flashback Friday
FBO - Facebook official
FF - Follow Friday
FIMH - Forever in my heart
FOMO - Fear of Missing Out
FTFY - Fixed that for you
FTW - For the win   
FUTAB - Feet up  take a break
FYI - For your information
GBP - Google Business Profile
G2G - Got to go
GA - Google Analytics
GG - Good game
Gr8 - Great
GRWM - Get ready with me
GMTA - Great minds think alike
GOAT - Greatest of all time
GTG - Got to go
GTR - Got to run
HBD - Happy birthday
HIFW - How I feel when
HMB - Hit me back
HMU - Hit me up
HT - Hat tip
HTH - Happy to help
HTML - Hyper Text Markup Language
IANAD - I am not a doctor
IANAL - I am not a lawyer
ICYMI - In case you missed it
IDC - I do not care
IDK - I do not know
IFYP - I feel your pain
IG - Instagram
IKR - I know  right   
ILY - I love you
IM - Instant message
IMHO - In my humble opinion
IMO - In my opinion
IMU - I miss you
IO - Insertion order
IRL - In real life
ISP - Internet service provider
JK - Just kidding
KPI - Key Performance Indicator
L8 - Late
LI - LinkedIn
LMAO - Laughing my ass off
LMK - Let me know
LMS - Like my status
LOL - Laughing out loud
LOLz - Laughing out loud
MCM - Man crush Monday
MFW - My face when
MM - Music Monday
MSG - Message
MT - Modified tweet
MTFBWY - May the force be with you
NBD - No big deal
NM - Not much
NSFL - Not safe for life
NSFW - Not safe for work
NVM - Never mind
OAN - On another note
OH - Overheard
OMG - Oh my God
OMW - On my way
OOO - Out of office
OOTD - Outfit of the day
OP - Original poster
ORLY - Oh really      
OTP - One true pairing
P2P - Person to person  or peer to peer
POTD - Photo of the day
PPC - Pay per click
PM - Private message
PPL - People
PR - PageRank  or Public relations
PSA - Public service announcement
PV - Pageviews
QOTD - Quote of the Day
QQ - Crying
ROFL - Rolling on the floor laughing
ROFLMAO - Rolling on the floor laughing my ass off
ROI - Return on investment
RSS - Really simple syndication
RT - Retweet
RTD - Real time data
SaaS - Software as a service
SC - Snapchat
SEM - Search engine marketing
SEO - Search engine optimization
SERP - Search engine results page
SFW - Safe for work
SM - Social media
SMB - Small and medium sized business
SMH - Shaking my head
SMM - Social media marketing
SMO - Social media optimization
SMP - Social media platform
SoLoMo - Social  Local  Mobile
SOV - Share of voice
SSDD - Same stuff  different day
Sus - Suspicious or sketchy
TBH - To be honest
TBT - Throwback Thursday
TFW - That feeling when
TGIF - Thank goodness it is Friday
Thx - Thanks
TIL - Today I learned
TIME - Tears in my eyes
TL;DR - Too Long Did not Read
TLDR - Too Long Did not Read
TMI - Too much information
TNTL - Trying not to laugh
TOS - Terms of Service
TTYL - Talk to you later
TTYN - Talk to you never
TTYS - Talk to you soon
TW - Twitter
Txt - Text
UGC - User generated content
UI - User interface
URL - Uniform Resource Locator
UV - Unique visitor
UX - User experience
w/ - With
WBU - What about you   
WCW - Woman crush Wednesday
WDYMBT - What do you mean by that   
WFH - Working from home
WOM - Word of mouth
WOTD - Word of the Day
WYWH - Wish you were here
YGTR - You got that right
YMMV - Your mileage may vary
YOLO - You only live once
YSK - You should know
YT - YouTube